#....................................................#
#....................................................#
#....................................................#
#....................................................#
#....................................................#
#..x...................................xx............#
#.....##.................###.........""""............#
#..........""........................................#
#.............xx....##x.....0.......x...0...#......0.#
""""""""""""""""""""""""""""""""""""""""""""""""""""""
